    
NO      textures/n.xpm
SO       textures/s.xpm
WE     textures/w.xpm
EA    textures/e.xpm

C        173,216,230
F 250,213,165
    
        11111111111111111111111111
11111111111111111111111111
11111111001100000000000011
10110000011100000000000011
10010000000000000000000011111111
111111111011000001110000000000001
100000000011000001110111111111111
11110111111111011100000010001
11110111111111011101010011101
110000001101010000000001   11
10000000000000000000000011101
10000000000000000000000000001
11000000000000E00000000000001
111100000000000000000000000001
1111111111111111111111111111111
